################################################################################
################################################################################
##################################################....#############..........###
##################################################....#############..........###
##################################################....#############..........###
#######################################......................................###
#######################################.##########....#############..........###
#######################################.##########....#############..........###
#################......##############....###########.###################.#######
#################......##############....###########.###################.#######
#####....................................###########.###################.#######
#####....########......##############....###########.###################.#######
#####..................################.############.###################.#######
#####....########......################.############.###################.#######
#####....########......################.############.###################.#######
#####....########......################.####..........################......####
#####....########......################.####..........################......####
#####....#######################..........##..........################......####
#######.########################..........##..........################......####
#######.########################..........##..........################......####
#######.########################..........############################......####
#######.########################..........############################......####
#######.########################..........############################......####
#######.########.........#######..........############################......####
#######.########.........##############.########################################
##.......................##############.########################################
##.........#####.........##############.########################################
##.........#####.........##############.########################################
##.........######################....##.########################################
#######.#########################....##.########################################
#######.#########################....##.########################################
#######.#########################.......#############################......#####
#######.#########################....##.###############.......#######......#####
#######.#########################....##.###############.......#######......#####
#######.#########################..........................................#####
#######.###########################.###.###############.......#######......#####
#.....#.###########################.###.###############.......#######......#####
#.....#.###########################.###.##################.##########......#####
#.......###########################.###.##################.#############.#######
#.....#.###########################.###.##################.#############.#######
###.###.###########################.###.##################.#############.#######
###.###.##############......#######.###.##################.#############.#######
###.###.##############......#######.###.##################.#############.#######
###.........................#######.###.##################.#############.#######
###.###.##############......#######.###.##################.#############.#######
###.###.##############......#######.........#########..........#########.#######
###.###.#################.#########.........#########..........#########.#######
###.###.#################.#########.........#########..........###.......#######
###.###.....#############.##########........#########..........###.......#######
###.###.....####..........##########........#########..........###.......#######
###.........####..........#############.#############..........###.......#######
#######.....####..........#############.##########################.......#######
#######.########..........#############.########################################
#######.########..........#############.########################################
#######.########.........##############.########################################
#######.########.........##############.########################################
#######.########.........##############.########################################
#######.########.........##############.########################################
#######.###############################.........#####....###########..........##
#######.###############################.........#####....###########..........##
#######.###############################.......................................##
#######.#########........##############.........#####....###########..........##
#######.#########........##############.........#######.############..........##
#######..................##############.........#######.#################.######
#######.#########........##################.###########.#################.######
#######.#########........##################.###########.#################.######
#######.###################################.###########.#################.######
##..........###############################.###########.#################.######
##..........###############################.###########.#################.######
##..........###############################.###########.#################.######
##..........###############################.###########..........########.######
###########################################.###########..........########.######
###########################################.###########..........########.######
###########################################.###########..........#######.......#
###########################################.###########..........#######.......#
################################......#####.############################.......#
################################......#####.############################.......#
################################............####################################
################################......##########################################
################################################################################
