╔═══════════════════════╗
║                       ║
║                       ║
║                       ║
║                       ║
║                       ║
║                       ║
║                       ║
║                       ║
║                       ║
║                       ║
║                       ║
║                       ║
╚═══════════════════════╝